green: 0, Q, W, E, R
cyan: 1, Z, X, C, V
magenta: 2, B, N, M, L
pink: 3, G, H, J, K
++++++++++++++++++++++++++++++++++++++++++++++++++
+q+h+n+v+Q+H+N+V++++++++++++++++++++++++++++++++++
+z+b+c+l+L+C+B+Z++++++++++++++++++++++++++++++++++
+b+x+e+k+B+X+E+K++++++++++++++++++++++++++++++++++
+g+q+j+r+R+J+Q+G++++++++++++++++++++++++++++++++++
+               ++++++++++++++++++++++++++++++++++
+ 0 1 2 3       ++++++++++++++++++++++++++++++++++
++++++++++++++++++++++++++++++++++++++++++++++++++
