green: 1, Q, W, E, R, T, Y, U, I, P, O, A, S, D, F
cyan: 0, Z, X, C, V
magenta: B, N, M, L
pink: G, H, J, K
++++++++++++++++++++++++++++++++++++++++++++++++++
++++++++++++++++++++++++++++++++++++++++++++++++++
++++++++++++++++++++++++++++++++++++++++++++++++++
++++++++++++++++++++++++++++++++++++++++++++++++++
++++++++++++++++++++++++++++++++++++++++++++++++++
++++++++++++++++++++++++++++++++++++++++++++++++++
++++++++++++++++++++++++++++++++++++++++++++++++++
++++++++++++++++++++++++++++++++++++++++++++++++++
++++++++++++++++++++++++++++++++++++++++++++++++++
++++++++++++++++++++++++++++++++++++++++++++++++++
++++++++++++++++++++++++++++++++++++++++++++++++++
++++++++++++++++++++++++++++++++++++++++++++++++++
++++++++++++++++++++++++++++++++++++++++++++++++++
++++++++++++++++++++++++++++++++++++++++++++++++++
++++++++++++++++++++++++++++++++++++++++++++++++++
++++++++++++++++++++++++++++++++++++++++++++++++++
++++++++++++++++++++++++++++++++++++++++++++++++++
+    +YT++R+E++WQ+    ++++++++++++++++++++++++++++
+     +DS+AOP+IU+     ++++++++++++++++++++++++++++
+++++++    F   +++++++++++++++++++++++++++++++++++
+zxcv  1+ +++ +0  VCXZ++++++++++++++++++++++++++++
++++++++   f    ++++++++++++++++++++++++++++++++++
+     +ui+poa+sd+     ++++++++++++++++++++++++++++
+    +qw++e+r++ty+    ++++++++++++++++++++++++++++
++++++++++++++++++++++++++++++++++++++++++++++++++
