green: 0, 1, 5, Q, W, E, R, T, Y, U, I, P, O, A, S, D, F
cyan: 2, Z, X, C, V
magenta: 3, 7, B, N, M, L
pink: 4, 6, G, H, J, K
++++++++++++++++++++++++++++++++++++++++++++++++++
+OOOOOOOOO++OOOOOOOO++OOOOOOOO++OOOOOOO+OOOOOOOOO+
+ 0OOOOOOOOOOOOOOOOOOOOOOOOOOOOOOOOOOOOOOOOOOOOOO+
+OOOO++OOOOOOOO++OOOOOOOO++OOOOOOO++OOOOOOOOOOOOO+
++++++++++++++++++++++++++++++++++++++++++++++OOO+
+LfKmngVJFXjScA saCMD vZlkdHhxN bGzBl+  5  +O+OOO+
+ZLVdhXbnxDf kvgHzjlN KsJBam AGCcFSM +D+ +p+O+OOO+
+                                    +A+ +i+O+OOO+
+fnMCh VgaKJFA DHXmcvd LjZsxkS lNzbBJ+W+ +u+O+OOO+
+cG nHAlzgF amxZjkfdBS NKMD hLvsbVC Z+R+ +y+O+OOO+
+                                    +Y+ +t+O+OOO+
+ HbaXxfB vskdSAg cjNmKFC zGMVLJZhDnG+I+ +r+OOOOO+
+sLvVHGMB ACXSdKkx jlmhDN Fnzagfb cJX+ + +e+OOOOO+
+1 2 3 4                             +U+ +w+OOOOO+
+                                    +T+ +q+++++++
+                                    +E+ +a+++++++
++++++++++++++++++++++++++++++++++++++Q+ +s+++++++
++++++++++++++++++++++++++++++++++++++S+ +d+++++++
++++++++++++++++++++++++++++++++++++++F+ +f+++++++
++++++++++++++++++++++++++++++++++++++++++P+++++++
++++++++++++++++++++++++++++++++++++++++++++++++++