green: 0, 1, 5,6, Q, W, E, R, T, Y, U, I, P, O, A, S, D, F
cyan: 2,7, Z, X, C, V
magenta: 3, B, N, M, L
pink: 4, G, H, J, K
++++++++++++++++++++++++++++++++++++++++++++++++++
+OOOOOOOOO++OOOOOOOO++OOOOOOOO++OOOOOOO+OOOOOOOOO+
+ 0OOOOOOOOOOOOOOOOOOOOOOOOOOOOOOOOOOOOOOOOOOOOOO+
+OOOO++OOOOOOOO++OOOOOOOO++OOOOOOO++OOOOOOOOOOOOO+
++++++++++++++++++++++++++++++++++++++++++++++OOO+
+LfKmngVJFXjScA saCMD vZlkdHhxN bGzBl+  5  +O+OOO+
+ZLVdhXbnxDf kvgHzjlN KsJBam AGCcFSM +D+ +p+O+OOO+
+                                    +A+ +i+O+OOO+
+fnMCh VgaKJFA DHXmcvd LjZsxkS lNzbBJ+W+ +u+O+OOO+
+cG nHAlzgF amxZjkfdBS NKMD hLvsbVC Z+R+ +y+O+OOO+
+                                    +Y+ +t+O+OOO+
+ HbaXxfB vskdSAg cjNmKFC zGMVLJZhDnG+I+ +r+OOOOO+
+sLvVHGMB ACXSdKkx jlmhDN Fnzagfb cJX+ + +e+OOOOO+
+1 2 3 4                             +U+ +w+OOOOO+
+                                    +T+ +q+++++++
+                                    +E+ +a+++++++
++++++++++++++++++++++++++++++++++++++Q+ +s+++++++
+    +YT++R+E++WQ+    ++++++++++++++++S+ +d+++++++
+     +DS+AOP+IU+     ++++++++++++++++F+ +f+++++++
+++++++    F   +++++++++++++++++++++++++++P+++++++
+zxcv  7+ +++ +6  VCXZ++++++++++++++++++++++++++++
++++++++   f    ++++++++++++++++++++++++++++++++++
+     +ui+poa+sd+     ++++++++++++++++++++++++++++
+    +qw++e+r++ty+    ++++++++++++++++++++++++++++
++++++++++++++++++++++++++++++++++++++++++++++++++
