green:0,A
cyan:1,B
magenta:2,C
pink:3,D
red:4,E
++++++++++++++++++++
+e d c b a         +
++++++++++++++++++ +
+                + +
+ ++++++++++++++ + +
+ +            + + +
+ + ++++++++++ + + +
+ + +        + + + +
+ + + ++++++ + + + +
+ + + +3C2B+ + + + +
+ + + +D++1+ + + + +
+ + + +4+0A+ + + + +
+ + + +E++++ + + + +
+ + + +      + + + +
+ + + ++++++++ + + +
+ + +          + + +
+ + ++++++++++++ + +
+ +              + +
+ ++++++++++++++++ +
+                  +
++++++++++++++++++++