green: 0, Q, W, E, R, T, Y, U, I, P, O, A, S, D, F
cyan: 1, Z, X, C, V
+++++++++++++++++++++++
+    +YT++R+E++WQ+    +
+     +DS+AOP+IU+     +
+++++++    F   ++++++++
+zxcv  1+ +++ +0  VCXZ+
++++++++   f    +++++++
+     +ui+poa+sd+     +
+    +qw++e+r++ty+    +
+++++++++++++++++++++++