+++++++++++++
+         +B+
+0        +A+
+           +
+           +
+         +b+
+         +a+
+++++++++++++
          