+++++++++++++
+           +
+0A        a+
+           +
+           +
+           +
+          A+
+++++++++++++
          