+++++++++++++++++++++++
+    +DE++F+A++BC+    +
+     +KL+MJG+HI+     +
+      +SYU+XPO+      +
+       +VRTQN+       +
+        ++0++        +
+       +tuvxy+       +
+      +nop+qrs+      +
+     +gh+ijk+lm+     +
+    +ab++c+d++ef+    +
+++++++++++++++++++++++
