++++++++++++++++++++++
+        P+B         +
+       + + +        +
+    ++++ + ++++     +
+    +H 0ube  R+     +
+    ++++p+s++++     +
+    +A  rah  S+     +
+    ++++ + ++++     +
+       + + +        +
+        E+U         +
++++++++++++++++++++++