#domain
hospital
#levelname
MACorridor
#colors
purple: 0, A
orange: 1
#initial
++++++++++++++
+0A          +
++++++++++++ +
+ 1          +
++ +++++++++++
++ +++++++++++
++++++++++++++
#goal
++++++++++++++
+A           +
++++++++++++ +
+            +
++ +++++++++++
++ +++++++++++
++++++++++++++
#end
