#domain
hospital
#levelname
MAInterestingManeuver
#colors
purple: 0, 1, 2, 3, 4, A
#initial
++++++++++++
+0A    +   +
+++ ++++   +
++++++++   +
+1A    +   +
+++ ++++AAA+
++++++++AAA+
+A2    +AAA+
+++ ++++   +
++++++++   +
+A3    +   +
+++ ++++ 4 +
++++++++++++
#goal
++++++++++++
+    0A+ 4 +
+++ ++++   +
++++++++   +
+    A1+   +
+++ ++++   +
++++++++   +
+    2A+   +
+++ ++++   +
++++++++   +
+    A3+   +
+++ ++++   +
++++++++++++
#end
