#domain
hospital
#levelname
SAExample2
#colors
red: 0, A
#initial
++++++++++++
+       0+ +
+ ++++++++A+
+          +
+A++++++++ +
+ +        +
++++++++++++
#goal
++++++++++++
+        +A+
+ ++++++++ +
+          +
+ ++++++++ +
+A+        +
++++++++++++
#end
