#domain
hospital
#levelname
SALeo
#colors
orange: 0,L
#initial
++++++++++++++++++++++++++++++++++++++++++++++++++
+++++++++++++++++++++++LLLL+++++++++++++++++++++++
++++++++++++++++++++L+LLLLLLLLLLL+++++++++++++++++
+++++++++++++++++++LLLLLLLLLLL+LLLLLL+++++++++++++
++++++++++++++++++LLLLLLLLLLLLLLLLLLLL++++++++++++
+++++++++++++++++LLLLLLLLLLLLLLLLLLL++++++++++++++
++++++++++++++++LLLLLL+LLLLLLLLLLLLLLL++++++++++++
++++++++++++++++LLLLL++LLLLLLLLLLLLLLLLLL+++++++++
++++++++++++++++LLLL+++LLLLLLLLLLLLLLLLLLLL+++++++
+++++++++++++++LLLL+L++LLLLLLLLLLLLLLLLLLLLL++++++
+++++++++++LLLLLLLLLL++LLLLLLLLLLLLLL+++LL++++++++
++++++++++LLLLLLLLLLL++LLLLLLLLLLLLLLLLLL+++++++++
+++++++++LLLLLLLLLLLL+LLLLLLLLLLLLLLLLLLLLL+++++++
+++++++++LLLLLLLLLLLLLLLLLLLLLLLLLLLLLLLLLLL++++++
++++++LLLL  LLLLLLLLLLLLLLLLLLLLLLLLLLLLLLLLL+++++
++++LLLLL 0LLLLLL++LLLLLLLLLLLLLLLLLLLLLLLLLLL++++
+++LLLLLLLLLLLLLLL+LLLLLLLLLLLLLLLLLLLLLLLLLLLL+++
++LLLLLLLLLLLLLLLL+LLLLLLLLLLLLLL+++++++++++LLL+++
++LLLLLLLLLLLLLLLL++LLLLLLLL++LLLLLLLLLLLL++++++++
++L+LLLLLLLLLLLLLLL+LLLLLLLLLLLLLLLLLLLLLLLL++++++
++L+LLLLLLLLLLLLLL++LLLLLLLLLLLLLLLLLLLLLLLLL+++++
+++LLLLLLLLLLLLLLL+LLLLLLLLLLLLLLLLLLLLLLLLLLL++++
+++LLLLLLLLLLLLL+++LLLLLLLLLLLLLLLLLLLLLLLLLLLL+++
++++++++LLLLLLLLL+LLLLLLLLLL+++++LLLLLLLLLLLLLL+++
+++++++++LLLLLLLL+LLLLLL+LLLLLLLL+++++++++++++++++
+++++LLLLLLLLLLLL+LLLLLLL+LLLLLLLLLLLLLLLLL+++++++
+++++LLLLLLLLLLL+LLLLLLLLL++LLLLLLLLLLLLLLLLL+++++
+++++LLLLLLLLLL+LLLLLLLLLLLL++LLLLLLLLLLLLLLLL++++
+++++LLLLLLLLL++LLLLLLLLLLLLLL++++LLLLLLLLLLLL++++
+++++++LLLLLL++LLLLLLLL+LLLLLLLLL++++++++++LLLL+++
+++++++LLLL+++LLLLLLLLLL++LLLLLLLLLLL+++++++++++++
+++++++++L++LLLLLLL+LLLLL++LLLLLLLLLL+++++++++++++
+++++++++++LLLLLLLL+LLLLLLL++LLLLLLLL+++++++++++++
++++++++++LLLLLLLLLL+LLLLLLL++LLLLLLL+++++++++++++
++++++++++LLLLLL+LLL++LLLLLLLL+++LLLL+++++++++++++
+++++++++LLLLLLL+LLLL++LLLLLLLL+++++L+++++++++++++
+++++++++LLLLLLL++LLLL++LLLLLLL+++++++++++++++++++
++++++++LLLL+LLLL+LLLLL++LLLLLL+++++++++++++++++++
++++++++LLLL+LLLL++LLLLL+++LLLL+++++++++++++++++++
+++++++LLLLL+LLLLL++LLL+++++++++++++++++++++++++++
+++++++LLLLL++LLL++++LL+++++++++++++++++++++++++++
+++++++LLLLLL++L++++++++++++++++++++++++++++++++++
+++++++LLLLL++++++++++++++++++++++++++++++++++++++
+++++++LLLL+++++++++++++++++++++++++++++++++++++++
+++++++LLLL+++++++++++++++++++++++++++++++++++++++
+++++++LLL++++++++++++++++++++++++++++++++++++++++
+++++++LLL++++++++++++++++++++++++++++++++++++++++
++++++++L+++++++++++++++++++++++++++++++++++++++++
++++++++L+++++++++++++++++++++++++++++++++++++++++
++++++++++++++++++++++++++++++++++++++++++++++++++

#goal
++++++++++++++++++++++++++++++++++++++++++++++++++
+++++++++++++++++++++++LLLL+++++++++++++++++++++++
++++++++++++++++++++L+LLLLLLLLLLL+++++++++++++++++
+++++++++++++++++++LLLLLLLLLLL+LLLLLL+++++++++++++
++++++++++++++++++LLLLLLLLLLLLLLLLLLLL++++++++++++
+++++++++++++++++LLLLLLLLLLLLLLLLLLL++++++++++++++
++++++++++++++++LLLLLL+LLLLLLLLLLLLLLL++++++++++++
++++++++++++++++LLLLL++LLLLLLLLLLLLLLLLLL+++++++++
++++++++++++++++LLLL+++LLLLLLLLLLLLLLLLLLLL+++++++
+++++++++++++++LLLL+L++LLLLLLLLLLLLLLLLLLLLL++++++
+++++++++++LLLLLLLLLL++LLLLLLLLLLLLLL+++LL++++++++
++++++++++LLLLLLLLLLL++LLLLLLLLLLLLLLLLLL+++++++++
+++++++++LLLLLLLLLLLL+LLLLLLLLLLLLLLLLLLLLL+++++++
+++++++++LLLLLLLLLLLLLLLLLLLLLLLLLLLLLLLLLLL++++++
++++++LLLL  LLLLLLLLLLLLLLLLLLLLLLLLLLLLLLLLL+++++
++++LLLLLL LLLLLL++LLLLLLLLLLLLLLLLLLLLLLLLLLL++++
+++LLLLLLLLLLLLLLL+LLLLLLLLLLLLLLLLLLLLLLLLLLLL+++
++LLLLLLLLLLLLLLLL+LLLLLLLLLLLLLL+++++++++++LLL+++
++LLLLLLLLLLLLLLLL++LLLLLLLL++LLLLLLLLLLLL++++++++
++L+LLLLLLLLLLLLLLL+LLLLLLLLLLLLLLLLLLLLLLLL++++++
++L+LLLLLLLLLLLLLL++LLLLLLLLLLLLLLLLLLLLLLLLL+++++
+++LLLLLLLLLLLLLLL+LLLLLLLLLLLLLLLLLLLLLLLLLLL++++
+++LLLLLLLLLLLLL+++LLLLLLLLLLLLLLLLLLLLLLLLLLLL+++
++++++++LLLLLLLLL+LLLLLLLLLL+++++LLLLLLLLLLLLLL+++
+++++++++LLLLLLLL+LLLLLL+LLLLLLLL+++++++++++++++++
+++++LLLLLLLLLLLL+LLLLLLL+LLLLLLLLLLLLLLLLL+++++++
+++++LLLLLLLLLLL+LLLLLLLLL++LLLLLLLLLLLLLLLLL+++++
+++++LLLLLLLLLL+LLLLLLLLLLLL++LLLLLLLLLLLLLLLL++++
+++++LLLLLLLLL++LLLLLLLLLLLLLL++++LLLLLLLLLLLL++++
+++++++LLLLLL++LLLLLLLL+LLLLLLLLL++++++++++LLLL+++
+++++++LLLL+++LLLLLLLLLL++LLLLLLLLLLL+++++++++++++
+++++++++L++LLLLLLL+LLLLL++LLLLLLLLLL+++++++++++++
+++++++++++LLLLLLLL+LLLLLLL++LLLLLLLL+++++++++++++
++++++++++LLLLLLLLLL+LLLLLLL++LLLLLLL+++++++++++++
++++++++++LLLLLL+LLL++LLLLLLLL+++LLLL+++++++++++++
+++++++++LLLLLLL+LLLL++LLLLLLLL+++++L+++++++++++++
+++++++++LLLLLLL++LLLL++LLLLLLL+++++++++++++++++++
++++++++LLLL+LLLL+LLLLL++LLLLLL+++++++++++++++++++
++++++++LLLL+LLLL++LLLLL+++LLLL+++++++++++++++++++
+++++++LLLLL+LLLLL++LLL+++++++++++++++++++++++++++
+++++++LLLLL++LLL++++LL+++++++++++++++++++++++++++
+++++++LLLLLL++L++++++++++++++++++++++++++++++++++
+++++++LLLLL++++++++++++++++++++++++++++++++++++++
+++++++LLLL+++++++++++++++++++++++++++++++++++++++
+++++++LLLL+++++++++++++++++++++++++++++++++++++++
+++++++LLL++++++++++++++++++++++++++++++++++++++++
+++++++LL0++++++++++++++++++++++++++++++++++++++++
++++++++L+++++++++++++++++++++++++++++++++++++++++
++++++++L+++++++++++++++++++++++++++++++++++++++++
++++++++++++++++++++++++++++++++++++++++++++++++++

#end
