#domain
hospital
#levelname
SALeo
#colors
brown: L
red: E
orange: 0,O
#initial
++++++++++++++++++++++++++++++++++++++++++++++++++
+++++++++++++++++++++++LLLL+++++++++++++++++++++++
++++++++++++++++++++L+LOOOOLLLLLL+++++++++++++++++
+++++++++++++++++++LLLOEEEEOOO+OOOLLL+++++++++++++
++++++++++++++++++LLOLLLLLLEEEEEEOOOLL++++++++++++
+++++++++++++++++LLOELLLLLLLLLLLLELL++++++++++++++
++++++++++++++++LLOELL+LLLLLLLLLLLLLLL++++++++++++
++++++++++++++++LOELL++LLOLOOOOOOOOOOOLLL+++++++++
++++++++++++++++LOLL+++LLO+LOOOEEEEEEEOOOLL+++++++
+++++++++++++++LOEL+L++LLO++LLOOOLLLLLEEEOLL++++++
+++++++++++OOOOOOLOOL++LOL++++LOOOOOL+++LL++++++++
++++++++++OOOOOOOOOOL++LO+++LL+LOOEEOLLLL+++++++++
+++++++++OOOOOOOOOOOL+LOL+++LOL+LOLLEOOOOLL+++++++
+++++++++OOOOOOOOOEOOLOOOL+LOOL+LOOLLEEEEOOE++++++
++++++LOOO0 OOOOOLLEOOEOOL+LOOL+LOOOLLLLLEEOE+++++
++++LLOOO  OOOOLL++LEOEOOL+LOOOLLOOOOLLLLLLELE++++
+++LOOOOOOOOOLLLLL+LEOEOOL+LOOOOOOLLLLLLLLLEEEE+++
++LLLOOOOOLLLLLLLL+LEOOEO+LOOOOOO+++++++++++EEE+++
++LOOLLLLLLLLLLLLL++LEOEO+LO++OOOLLLLLLLEE++++++++
++OO+ OOOOOOOOOLLLL+LEOE+LOOOOOOOOOLLLLLLEEE++++++
++O++ OOOOOOOOOOLL++LEOO+OOOOOOOOOOOOOOOOLEEE+++++
+++   OOOOOOOOOOOO+LEOO+LOOOOOLLLLLLLLLOOOOEEE++++
+++    OOOOOOOOO+++LOOO+OOOOLLLLLLLLLLLLLLLOEEE+++
++++++++OOOOOOOOO+LEOLOOOOOL+++++LLLLLLLLLLLLEE+++
+++++E++++++OOOOO+LEOLOO+OOOLLLLL+++++++++++++++++
+++++OOOOOOOOO OO+LEOLOOL+LLOOOOOLLLLLLLEEE+++++++
+++++ OOOOOOO  O+LEOLLOOLL++LLOOOOOOOOOOOOEEE+++++
+++++     L+   +LEOOLLOOOLLL++LLLLOOOOOOOOOOEE++++
+++++      L  ++LEOLLOOLOOLLLL++++LLLLLLLLLOOE++++
+++++++   LO ++LEOLLOOO+LLOOLLEEE++++++++++LLLE+++
+++++++    +++LEOOOOOOOL++LOLLLLLEEEE+++++++++++++
+++++++++ ++LLOEOOO+LOOLL++LLOLLLLLLE+++++++++++++
+++++++++++LOOOOOOO+LLOOLLL++LOOOLLLE+++++++++++++
++++++++++LLOOOOLOOL+LLLOLLL++LLLOOOE+++++++++++++
++++++++++LOOOOL+LOL++LLLLLLEE+++LLLE+++++++++++++
+++++++++LLOLOOL+LOLL++LLLLLLLE+++++L+++++++++++++
+++++++++LOLLOLL++LLLL++LLLLLLE+++++++++++++++++++
++++++++LLOL+LLLL+LLLLE++LLLLLE+++++++++++++++++++
++++++++LLLL+LLLL++LLLLE+++LLLE+++++++++++++++++++
+++++++LLLLL+LLLLL++LLE+++++++++++++++++++++++++++
+++++++LLLLL++LLL++++LE+++++++++++++++++++++++++++
+++++++LLLLLL++L++++++++++++++++++++++++++++++++++
+++++++LLLLL++++++++++++++++++++++++++++++++++++++
+++++++LLLL+++++++++++++++++++++++++++++++++++++++
+++++++LLLL+++++++++++++++++++++++++++++++++++++++
+++++++LLL++++++++++++++++++++++++++++++++++++++++
+++++++LLL++++++++++++++++++++++++++++++++++++++++
++++++++L+++++++++++++++++++++++++++++++++++++++++
++++++++L+++++++++++++++++++++++++++++++++++++++++
++++++++++++++++++++++++++++++++++++++++++++++++++
#goal
++++++++++++++++++++++++++++++++++++++++++++++++++
+++++++++++++++++++++++LLLL+++++++++++++++++++++++
++++++++++++++++++++L+LOOOOLLLLLL+++++++++++++++++
+++++++++++++++++++LLLOEEEEOOO+OOOLLL+++++++++++++
++++++++++++++++++LLOLLLLLLEEEEEEOOOLL++++++++++++
+++++++++++++++++LLOELLLLLLLLLLLLELL++++++++++++++
++++++++++++++++LLOELL+LLLLLLLLLLLLLLL++++++++++++
++++++++++++++++LOELL++LLOLOOOOOOOOOOOLLL+++++++++
++++++++++++++++LOLL+++LLO+LOOOEEEEEEEOOOLL+++++++
+++++++++++++++LOEL+L++LLO++LLOOOLLLLLEEEOLL++++++
+++++++++++OOOOOOLOOL++LOL++++LOOOOOL+++LL++++++++
++++++++++OOOOOOOOOOL++LO+++LL+LOOEEOLLLL+++++++++
+++++++++OOOOOOOOOOOL+LOL+++LOL+LOLLEOOOOLL+++++++
+++++++++OOOOOOOOOEOOLOOOL+LOOL+LOOLLEEEEOOE++++++
++++++LOOOO OOOOOLLEOOEOOL+LOOL+LOOOLLLLLEEOE+++++
++++LLOOO  OOOOLL++LEOEOOL+LOOOLLOOOOLLLLLLELE++++
+++LOOOOOOOOOLLLLL+LEOEOOL+LOOOOOOLLLLLLLLLEEEE+++
++LLLOOOOOLLLLLLLL+LEOOEO+LOOOOOO+++++++++++EEE+++
++LOOLLLLLLLLLLLLL++LEOEO+LO++OOOLLLLLLLEE++++++++
++OO+ OOOOOOOOOLLLL+LEOE+LOOOOOOOOOLLLLLLEEE++++++
++O++ OOOOOOOOOOLL++LEOO+OOOOOOOOOOOOOOOOLEEE+++++
+++   OOOOOOOOOOOO+LEOO+LOOOOOLLLLLLLLLOOOOEEE++++
+++    OOOOOOOOO+++LOOO+OOOOLLLLLLLLLLLLLLLOEEE+++
++++++++OOOOOOOOO+LEOLOOOOOL+++++LLLLLLLLLLLLEE+++
+++++E++++++OOOOO+LEOLOO+OOOLLLLL+++++++++++++++++
+++++OOOOOOOOO OO+LEOLOOL+LLOOOOOLLLLLLLEEE+++++++
+++++ OOOOOOO  O+LEOLLOOLL++LLOOOOOOOOOOOOEEE+++++
+++++     L+   +LEOOLLOOOLLL++LLLLOOOOOOOOOOEE++++
+++++      L  ++LEOLLOOLOOLLLL++++LLLLLLLLLOOE++++
+++++++   LO ++LEOLLOOO+LLOOLLEEE++++++++++LLLE+++
+++++++    +++LEOOOOOOOL++LOLLLLLEEEE+++++++++++++
+++++++++ ++LLOEOOO+LOOLL++LLOLLLLLLE+++++++++++++
+++++++++++LOOOOOOO+LLOOLLL++LOOOLLLE+++++++++++++
++++++++++LLOOOOLOOL+LLLOLLL++LLLOOOE+++++++++++++
++++++++++LO0OOL+LOL++LLLLLLEE+++LLLE+++++++++++++
+++++++++LLOLOOL+LOLL++LLLLLLLE+++++L+++++++++++++
+++++++++LOLLOLL++LLLL++LLLLLLE+++++++++++++++++++
++++++++LLOL+LLLL+LLLLE++LLLLLE+++++++++++++++++++
++++++++LLLL+LLLL++LLLLE+++LLLE+++++++++++++++++++
+++++++LLLLL+LLLLL++LLE+++++++++++++++++++++++++++
+++++++LLLLL++LLL++++LE+++++++++++++++++++++++++++
+++++++LLLLLL++L++++++++++++++++++++++++++++++++++
+++++++LLLLL++++++++++++++++++++++++++++++++++++++
+++++++LLLL+++++++++++++++++++++++++++++++++++++++
+++++++LLLL+++++++++++++++++++++++++++++++++++++++
+++++++LLL++++++++++++++++++++++++++++++++++++++++
+++++++LLL++++++++++++++++++++++++++++++++++++++++
++++++++L+++++++++++++++++++++++++++++++++++++++++
++++++++L+++++++++++++++++++++++++++++++++++++++++
++++++++++++++++++++++++++++++++++++++++++++++++++
#end
