+++++++++++
+++++A+++++
+++++a+++++
+B c e b C+
+++ +d+ +++
+++  +  +++
++++ d ++++
+++++0+++++
+++++A+++++
++++D D++++
+++++E+++++
+++++++++++