++++++++++++++
+            +
+            + 
+     0Aa    + 
+    cCB     +
+      b     +
++++++++++++++
