++++++++++++++++++++++++++++++++++++++++++++++++++++++++++++++++++
+0A                                                             a+
+                                                                +
+                                                                +
+                                                                +
+                                                                +
+                                                                +
+                                                                +
+                                                                +
+                                                                +
+                                                                +
+                                                                +
+                                                                +
+                                                                +
+                                                                +
+                                                                +
+                                                                +
+                                                                +
+                                                                +
+                                                                +
+                                                                +
+                                                                +
+                                                                +
+                                                                +
+                                                                +
+                                                                +
+                                                                +
+                                                                +
+                                                                +
+                                                                +
+                                                                +
+                                                                +
+                                                                +
+                                                                +
+                                                                +
+                                                                +
+                                                                +
+                                                                +
+                                                                +
+                                                                +
+                                                                +
+                                                                +
+                                                                +
+                                                                +
+                                                                +
+                                                                +
+                                                                +
+                                                                +
+                                                                +
+                                                                +
+                                                                +
+                                                                +
+                                                                +
+                                                                +
+                                                                +
+                                                                +
+                                                                +
+                                                                +
+                                                                +
+                                                                +
+                                                                +
+                                                                +
+                                                                +
+                                                                +
+                                                                +
++++++++++++++++++++++++++++++++++++++++++++++++++++++++++++++++++
