++++++++++++++++++++++++++++++++++
+0A                             a+
+                                +
+                                +
+                                +
+                                +
+                                +
+                                +
+                                +
+                                +
+                                +
+                                +
+                                +
+                                +
+                                +
+                                +
+                                +
+                                +
+                                +
+                                +
+                                +
+                                +
+                                +
+                                +
+                                +
+                                +
+                                +
+                                +
+                                +
+                                +
+                                +
+                                +
+                                +
++++++++++++++++++++++++++++++++++
