++++++++++++++++++
+0A             a+
+                +
+                +
+                +
+                +
+                +
+                +
+                +
+                +
+                +
+                +
+                +
+                +
+                +
+                +
+                +
++++++++++++++++++
