++++++++++
+0A     a+
+        +
+        +
+        +
+        +
+        +
+        +
+        +
++++++++++
