#domain
hospital
#levelname
SAGruppeTo
#colors
blue: 0, A, B, C, D, E, F, G
#initial
+++++++++++++
+++++++++ +++
++++ ++++ +++
+0          +
+ +++ +++ +++
+A+++++++ +++
+B+++++++++++
+G+++++++++++
+C+++++++++++
+D+++++++++++
+E+++++++++++
+F+++++++++++
+++++++++++++
#goal
+++++++++++++
+++++++++C+++
++++ ++++E+++
+        ABG+
+ +++ +++F+++
+ +++++++D+++
+ +++++++++++
+ +++++++++++
+ +++++++++++
+ +++++++++++
+ +++++++++++
+ +++++++++++
+++++++++++++
#end
